awake|awoke|awoken|ตื่น
be|was, were|been|เป็น,อยู่,คือ
bear|bore|born|ทน
beat|beat|beat|ตี
become|became|become|กลายเป็น
begin|began|begun|เริ่ม
bend|bent|bent|หัก, งอ
beset|beset|beset|โอบล้อมรอบด้าน
bet|bet|bet|พนัน
bid|bid/bade|bid/bidden|ประมูล
bind|bound|bound|ผูกติดกัน
bite|bit|bitten|กัด
bleed|bled|bled|เลือดออก
blow|blew|blown|เป่า
break|broke|broken|แตก, หัก
breed|bred|bred|ผสมพันธ์
bring|brought|brought|นำมา
broadcast|broadcast|broadcast|ออกอากาศ
build|built|built|สร้าง
burn|burned/burnt|burned/burnt|เผา
burst|burst|burst|ระเบิดออก
buy|bought|bought|ซื้อ
cast|cast|cast|หล่อ
catch|caught|caught|จับ
oose|chose|chosen|เลือก
cling|clung|clung|พิง
come|came|come|มา
cost|cost|cost|มีราคา
creep|crept|crept|คืบคลาน
cut|cut|cut|ตัด
deal|dealt|dealt|จัดการ
dig|dug|dug|ขุด
dive|dived/dove|dived|กระโดดน้ำ
do|did|done|ทำ
draw|drew|drawn|วาด, ล่อ, ชักดาบ, ถอนเงิน
dream|dreamed/dreamt|dreamed/dreamt|ฝัน
drive|drove|driven|ขับรถ
drink|drank|drunk|ดื่ม
eat|ate|eaten|กิน
fall|fell|fallen|ล้ม
feed|fed|fed|ให้อาหารสัตว์
feel|felt|felt|รู้สึก
fight|fought|fought|ต่อสู้
find|found|found|พบ
fit|fit|fit|พอเหมาะ
flee|fled|fled|หลบหนี
fling|flung|flung|เขวี้ยง
fly|flew|flown|บิน, นั่งเครื่องบิน
forbid|forbade|forbidden|ห้าม
forget|forgot|forgotten|ลืม
forego (forgo)|forewent|foregone|ยอม, ไม่เอา
forgive|forgave|forgiven|ให้อภัย
forsake|forsook|forsaken|สละ, ละทิ้ง
freeze|froze|frozen|หยุด, เป็นน้ำแข็ง
get|got|gotten|ได้
give|gave|given|ให้
go|went|gone|ไป
grind|ground|ground|บด
grow|grew|grown|เจริญงอกงาม
hang|hung|hung|แขวน
hang|hunged|hanged|แขวนคอ
hear|heard|heard|ได้ยิน
hide|hid|hidden|ซ่อน
hit|hit|hit|ตี
hold|held|held|ถือ
hurt|hurt|hurt|ทำร้าย
keep|kept|kept|เก็บรักษา
kneel|knelt|knelt|คุกเข่า
knit|knit|knit|ถัก
know|knew|know|รู้จัก
lay|laid|laid|วางไข่
lead|led|led|นำ
leap|leaped/lept|leaped/lept|กระโดด
learn|learned/learnt|learned/learnt|เรียน
leave|left|left|ออกจาก
lend|lent|lent|ให้ยืม
let|let|let|อนุญาต
lie|lay|lain|นอนลง
light|lighted/lit|lighted|จุดไฟ
lose|lost|lost|ทำหาย
make|made|made|ทำ
mean|meant|meant|หมายถึง
meet|met|met|พบ
misspell|misspelled /misspelt|misspelled/ misspelt|สะกดผิด
mistake|mistook|mistaken|ทำผิด
mow|mowed|mowed/mown|ตัดหญ้า
overcome|overcame|overcome|เอาชนะ
overdo|overdid|overdone|ทำมากเกินไป
overtake|overtook|overtaken|ตามทัน
overthrow|overthrew|overthrown|ปลดจากตำแหน่ง
pay|paid|paid|จ่าย
plead|pled|pled|อ้อนวอน, ขอโทษ
prove|proved|proved/proven|พิสูจน์
put|put|put|วาง
quit|quit|quit|เลิก
read|read|read|อ่าน
rid|rid|rid|ขจัด
ride|rode|ridden|ขี่
ring|rang|rung|กรดกริ่ง
rise|rose|risen|ลุกขึ้น
run|ran|run|วิ่ง
saw|sawed|sawed/sawn|เลื่อย
say|said|said|พูด
see|saw|seen|เห็น
seek|sought|sought|ค้นหา
sell|sold|sold|ขาย
send|sent|sent|ส่ง
set|set|set|จัดวาง
sew|sewed|sewed/sewn|เย็บ
shake|shook|shaken|สั่น
shave|shaved|shaved/shaven|โกน
shear|shore|shorn|ตัดขนแกะ
shed|shed|shed|เท, กันน้ำ, ทิ้ง
shine|shone|shone|เปล่งแสง
shoe|shoed|shoed/shod|ซ่อมรองเท้า
shoot|shot|shot|ยิง
show|showed|showed/shown|แสดง
shrink|shrank|shrunk|หด
shut|shut|shut|ปิด
sing|sang|sung|ร้องเพลง
sink|sank|sunk|จม
sit|sat|sat|นั่ง
sleep|slept|slept|นอน
slay|slew|slain|ฆ่า
slide|slid|slid|เลื่อน
sling|slung|slung|
slit|slit|slit|สอดกรีดตามยาว
smite|smote|smitten|ตีอย่างแรง
sow|sowed|sowed/sown|หว่านพืช
speak|spoke|spoken|พูด
speed|sped|sped|เร่งความเร็ว
spend|spent|spent|ใช้จ่าย
spill|spilled/spilt|spilled/spilt|ทำหก
spin|spun|spun|ปั่น
spit|spit/spat|spit|บ้วนน้ำลาย
split|split|split|แยกออกจากกัน
spread|spread|spread|แผ่
spring|sprang/sprung|sprung|กระโดด
stand|stood|stood|ยืน
steal|stole|stolen|ขโมย
stick|stuck|stuck|ติดอยู่กับ
sting|stung|stung|ปล่อยเหล็กไน
stink|stank|stunk|เหม็น
stride|strod|stridden|เดินก้าวยาว ๆ
strike|struck|struck|ตี
string|strung|strung|ขึ้นสาย, ร้อยลูกปัด
strive|strove|striven|ดิ้นรน ต่อสู้
swear|swore|sworn|สาบาน
sweep|swept|swept|กวาด
swell|swelled|swelled/swollen|บวม
swim|swam|swum|ว่ายน้ำ
swing|swung|swung|แกว่ง
take|took|taken|นำไป
teach|taught|taught|สอน
tear|tore|torn|ฉีก
tell|told|told|บอก
think|thought|thought|คิด
thrive|thrived/throve|thrived|เติบโต
throw|threw|thrown|ขว้าง
thrust|thrust|thrust|เสือกเข้าไป
tread|trod|trodden|เดิน
understand|understood|understood|เข้าใจ
uphold|upheld|upheld|ยกไว้
upset|upset|upset|เสียใจ
wake|woke|woken|ตื่น
wear|wore|worn|สวม
weave|weaved/wove|weaved/woven|ทอ
wed|wed|wed|แต่งงาน
weep|wept|wept|ร้องไห้
wind|wound|wound|ไขลาน
win|won|won|ชนะ
withhold|withheld|withheld|เก็บไว้
withstand|withstood|withstood|ทนฟ้าทนฝน
wring|wrung|wrung|บิด
write|wrote|written|เขียน
